111111111111111111111111111111111111111111111111111111111111
10000000PC00000000000000000000000100000000000000000000000001
10CC01111110000000000000000000000000000000000000000000000001
100011001HE0000000000000000000000000000000000000000000000001
111111111111111111111111111111111111111111111111111111111111