1111111111111
100000000C001
10CC011111001
100011E00P001
1111111111111