1111111111111111111111111111111111
10000P00E0000C00000C00000000000001
1111111111111111111111111111111111