1111111111111111111111111111111111
10000P00E000C000000C00000000000001
10000H0000000000000000000001000001
1111111111111111111111111111111111