1111111111111111111111111111111111
10000P00E000C000000C00000000000001
100000000000000000000C0000010000C1
1000000000000010000000000001000001
1000000H000000100C0000000001000001
1111111111111111111111111111111111