111111111111111
1001000C000C001
11C001111H00001
1P0011E100000C1
110100010001001
111111111111111