111111111111111
1001000C000C001
10C001111H00001
1P0011E000000C1
1001000C0001001
111111111111111