1111111111111
100100C0E00C1
1C00011111P01
1P0011E000001
1111111111111